NO        ./bricks.xpm      
SO ./bricks.xpm
WE ./bricks.xpm
EA ./bricks.xpm
F			 128,128,128
C 135,206,235
111111111111111111111111111111111111111111111111111111111111111111111111111111111111111111
101000001000000000000010000000101000000000001000000010000000000010001000101000000000D00011
10111000000000001110101011111010101110000000001110101011101111101010101010101D101110111011
100000000000000000D01010100010001010000000000010001010100010001010100010100010001010100011
111D110000000000111010101010111110101000000000101D10101011101010101D1110000000000010101111
10001000000000000010D000101000000010000000000010001010D01000D01010100000000000000000100011
101010000000000010101111101D11000000000000000011101010101110111010111010000000000011101011
1010000000000000D010000000100000000N000000000000001010100010000010001000000000000000101011
10111100000000001011101111101000000000000000001111101011101D111011101110100000000000111011
10000000000010001000101000101000000000000000001000001000000000000000100010000000000000D011
10111010111D11111110101010D01100000000101D101010111111100000000000111011100000000001101011
1010101010000000001010101010101000001010001010D0001000000000000000000010000000000000101011
101010111011101D10101110D0101011D11010111010101110D011100000000000001111101D10101111101011
101010000010001000100000100010000010101010101010001000000000000000000000100010101000001011
1010111D11101111D11D11111D1D11101010101010101010111111100000000000001110111110101011111011
100010000010000000000000000000101010001000101010001000000000000000000010000000100010000011
111111111111111111111111111111111111111111111111111111111111111111111111111111111111111111
101000000000000000101111111000000000000000000010000010100000000000000000000000000000000011
101011111110111110101000001011111111101111111010111010101111111111110111111111111111110111
100010000010100010101000101000000000100000001010001010100000000000000100000000000000000011
111110111010101010111010101011111110101111101011101010111111111D11111011111111111111111011
100000101010101000001010101000000010100000101000001010100000000000001000000000000000000011
101110101010101011111010101011111010111110101111101010101111111111101011111111111111110111
101000100010100010000010001000001010000010100000101000100000000000001000000000000000000011
101011111010101011111111D11111101011101010101111101011111111111111101111111111111111111011
100010000010101000000000000000101000010010100000101000000000000000001000000000000000000011
11111011101010111111111111111010111101D01011111101111111111111111110111111111111111111011
100000100010100000000000000010100000000010100000100000000000000000001000000000000000000011
101110111110111111111111111010111111111010111111101111111111111111101011111111111111110111
100010000000000000000000000010000000000010100000001000000000000000001000000000000000000011
111011111111111111111111111111111111111110101111111011111111111111111011111111111111110111
100010000000000000000000000000000000000000101000001000000000000000001000000000000000000011
10D00010001010001010001000100010000000001010001000101000D00010000010101000D010000000100011
10111D1110101010101011101111101000000111101111111010101110111010101110111010111111101D1011
10100000101000101010001000D0000010000000001000D0001010D000D000101000100010100010001000D011
10101D10101111101011101D1010111011101D11D1101010111010101110111011101110101D10101010101011
10001000000000001000001010001010001000000000101000D0D0100010001010000000100010001000101011
101110000000000011111010111110000000011110111111101011111011101011111111101011111110111011
100010000000000010000000000010000000001000100010001000001000101000000010101000000000100011
11101000000000001011111111111000000000111D1010101111111010101D11111110101011D111D111101111
101000000010101010100000001000000000000000001010000000101010001000100010000000000000100011
1011111110101011101011D110101000000001D1111110101D1D10101111101010101111111110111111111011
101000D0001010000010100010001000101000001000001010000010D000100010101000000010D0001000D011
101010101110111111101110111D111010101D101011111110111D101010111110101011111011101010101011
1000100000100000000000000000000010000010000000000010000000D0000000100000001000001000100011
111111111111111111111111111111111111111111111111111111111111111111111111111111111111111111























