NO        ./north.xpm          
SO ./south.xpm  
WE ./west.xpm  
EA    ./bricks.xpm
F 220,100,0
C			 2,	 25,  30     
			1111111111111111111111111111111111111111111
			1000000000000000000000000000000000000001
			1000000000000000000000000000000000000001
			1000000000000000000000000000000000000001
			1000000001000000000000000000000000000001
			1000000000100001111110000000000000000001
			1000000000000001    10000000000000000001
			1000000000000001    10000000000000000001
			1000000000000001    10000000000000000001
			1000000000000001111110000000000000000001
			1000000000000000000000000000000000000001
			1000000000000000000010000000000000000001
			10000000000000000001N1000000000000000001
			1000000000000000000010000000000000000001
			1000000000000000000000000000000000000001
			1111111111111111111111111111111111111111