NO         ./textures/bricks.xpm    
SO ./textures/bricks.xpm
WE ./textures/bricks.xpm
EA ./textures/bricks.xpm

F			 128,128,128
C 135,206,235

1   111
11111 1
1110111
110S0111
11101111111111111111111111111111111111111111111111111111111111111111111111111
1 111 1111111111111111111111111111                   111111111111111111
1111 1111111111111    111111111111111111111111111111111111111111111
1111 1111111111111111 111111111111111111111111111111111111111111111111111111111
1111 1111111111111111  11                        111111111111111
1111111111111111111111 11111111111111111111111111111
                     1 1