NO         ./textures/bricks.xpm    
SO ./textures/bricks.xpm
WE ./textures/bricks.xpm
EA ./textures/bricks.xpm
F			 128,128,128
C 135,206,235
11111111111111111111111111111111111111111
10000000000000000000000000000000000000001
10000000000000000000000000000000000000001
10000000000000000000000000000000000000001
10000000000000000000000000000000000000001
10000000000000000000000000000000000000001
10000000000000000000000000000000000000001
10000000000000  0000000000000000000000001
10000000000000000000000000000000000000001
10000000000000000000000000000000000000001
10000000000000000000000000000000000000001
10000000000000000000000000000000000000001
10000000000000000000000000000000000000001
10000000000000000000000000000000000000001
10000000000000000000000000000000000000001
100000000000000000N0000000000000000000001
10000000000000000000000000000000000000001
11111111111111111111111111111111111111111
